1111111111111111111111111111111111
1000000000000000100000000000000001
1000000000000000100000000000000001
1000000000000000100000000000000001
1P0000000C00C00000000000000E0000C1
1111111111111111111111111111111111