11111111111111111
1000001E100010001
100C0000001000101
11111111111111101
1P000000000000001
11111111111111111