1111111111111111111111111111111111
1000000000000000000000000000000001
1111111111111111111111111111111111
101001001010101000100100E000010101
1P0000000C00C0000000000000000000C1
1111111111111111111111111111111111